---------------------------------------------------------------------------------------------------------
-                                                                                                       -
-                                                   ***                                             -----
----                     --     -                                   **-          ---                    -
-       --*                            --                --                                             -
-                    --                       **               __                      ---              -
-             --                -*                                      -**                             -
-                                                                                                       -
---                  -*--                         -            --                                       -
-        --                    -         --*                                 *         --               -
---                                                  *                  -                     ---*      -
-         ---                  --                                     -                      -          -
-                            ---                                    -                       -           -
-                   --                   *          --            -                  --*                -
-                                                               -                                   -----
-     --*-                    **-                                      --                               -
-                                       --       *       -                                              -
-   ----*---        --*-                                         *          ---                *-       -
-                                 -             --                                                      -
-                                                            *-                     ----                -
-             --             --**          -*       --*                --                       -       -
-                                                                                                       -
-                      --           --**        --          ****-           --*          --             -
-----                        ---*          --*         --                               ---          -- -
-         --**-        ---                                                             ----             -
-*******--------    --    **       -***********************---**********---****       -----**       *   -
---------------------------------------------------------------------------------------------------------
