----------------------------------
-                                -
-                                -
----                     --     --
-       --*                      -
-                                -
-             --                 -
-                                -
---                  -*--        -
-                                -
---                              -
-         ---                    -
-                            --- -
-                   --           -
-                                -
-     --*-                       -
-                                -
-   ----*---        --*-         -
-                                -
-                                -
-             --             --**-
-                                -
-                      --        -
-----                        ---*-
-         --**-                  -
-***************-   -*********** -
----------------------------------
